{
    "first_map" : [
        [1,1,1,1,1,1,1,1,1,1,1,1,1,1,1,1,1,1,1,1,1,1,1,1,1,1],
        [1,1,1,1,1,1,1,0,0],
        [0,1,1,1,1,1,1,1,1],
        [1,1,1,1,1,1,1,1,1],
        [0,1,0,1,0,1,1,1,1]
    ],
    
    "second_map": [
        [0,0,0, 1, 1, 1],
        [1,1,1],
        [0,1,0,1,0,1,0,1]
    ]
}