{
    "hallway" : {
        "people" : {},
        "doors" : {},
        "dimensions" : [
        [1,1,1],
        [1,1,1],
        [1,1,1],
        [1,1,1],
        [1,1,1],
        [1,1,1],
        [1,1,1],
        [1,1,1],
        [1,1,1]
        ]
    },
    "square_room" : {
        "people" : {
            "n1": "44"
        },
        "doors": {
            "hallway": "02",
            "hallway2": "24",
            "rec_room": "42"
        },
        "enemies": {},
        
        "dimensions" : [
        [1,1,1,1,1],
        [1,1,1,1,1],
        [1,1,1,1,1],
        [1,1,1,1,1],
        [1,1,1,1,1]
        ]
    },

    "hallway2": {
        "people" : {},
        "doors" : {},
        "dimensions": [
        [0,0,0,0,0,1,1,1,1,1],
        [0,0,0,0,0,1,1,1,1,1],
        [0,0,0,0,0,1,1,1,1,1],
        [0,0,0,0,0,1,1,1,1,1],
        [0,0,0,0,0,1,1,1,1,1],
        [1,1,1,1,1,1,1,1,1,1],
        [1,1,1,1,1,1,1,1,1,1],
        [1,1,1,1,1,1,1,1,1,1],
        [1,1,1,1,1,1,1,1,1,1],
        [1,1,1,1,1,1,1,1,1,1]
        ]
    },

    "rec_room": [
        [1,1,1,1,1,1,1,1,1,1,1,1,1,1,1,1,1,1,1,1,1,1,1,1,1,1],
        [1,1,1,1,1,1,1,1,1,1,1,1,1,1,1,1,1,1,1,1,1,1,1,1,1,1],
        [1,1,1,1,1,1,1,1,1,1,1,1,1,1,1,1,1,1,1,1,1,1,1,1,1,1],
        [1,1,1,1,1,1,1,1,1,1,1,1,1,1,1,1,1,1,1,1,1,1,1,1,1,1],
        [1,1,1,1,1,1,1,1,1,1,1,1,1,1,1,1,1,1,1,1,1,1,1,1,1,1],
        [1,1,1,1,1,1,0,0,0,0,0,0,0,0,0,0,0,0,0,0,1,1,1,1,1,1],
        [1,1,1,1,1,1,0,0,0,0,0,0,0,0,0,0,0,0,0,0,1,1,1,1,1,1],
        [1,1,1,1,1,1,0,0,0,0,0,0,0,0,0,0,0,0,0,0,1,1,1,1,1,1],
        [1,1,1,1,1,1,0,0,0,0,0,0,0,0,0,0,0,0,0,0,1,1,1,1,1,1],
        [1,1,1,1,1,1,0,0,0,0,0,0,0,0,0,0,0,0,0,0,1,1,1,1,1,1]
    ]
}